DDDDDDDDDDDDDDD
DDRDDDDDDDDDDDD
DDDDDDDDDDDDDDD
DDDDDDDTTDDTTDD
DTPTTFTDDDDDDDD
DDDDDDDDDDDDDDD
DDDDDDDDDDDDDDD
DDDDDDDHDDDDDDD
DDRDDDDDDDDDDDD
DDDDDDDDDDDDDDD
DDDDDDDDDDDDDDD
DTTTPTTDDDDDDDD
DDDDDDDDDDTFTDD
DDDDDDDRDDDDDDD
DDDDDDDDDDDDDDD