DDDDDDDDDDRDDDD
DDDRDDDDDDDTFTD
DTTDTTDHDDDDDDD
DDDTPTTTTDDDDDD
DDDFTDDDDTPTTDD
DTFTDDDDDDDDDDD
DDDTDDDDDDDRDDD
DDTPTTTDDDDDDDD
DDDTDDDDDDDDRDD
DDPTTTDDDDDDDDD
DDDDDDDDDTTFTTD
DDDDDDDDDDTTPTD
DDTFTDDDDDDDDDD
DDRDDDDFTTDDDDD
DDDDTTTTDDDDDDD