DDDDDDDDDDDDDDD
DDDRDDDDDDDDDDD
DTTDTTDHDDDDDDD
DDDTDDDDDDDDDDD
DDDDDDDDDTPTTDD
DDDDDDDDDDDDDDD
DDDTDDDDDDDDDDD
DDTPTTTDDDDDDDD
DDDTDDDDDDDDRDD
DDDDDDDDDDDDDDD
DDDDDDDDDTTFTTD
DDDDDDDDDDDDDDD
DDDDDDDDDDDDDDD
DDDDDDDDDDDDDDD
DDDDDDDDDDDDDDD