DDDDTTFTTTDDDDD
DDDDDDDDDDDDRDD
DTTTTTDHDDDDDDD
DDDDTTTDFTDDDDD
RDDDDDDDDTPTTDD
DDDRTTTTDDDRDDD
DDDDDDDDDDDDDDD
DDTPTTTDDDDDDDD
DDDTDDDDDDDDRDD
DDDDDDDDDDDDDDD
DDDDDDDDDTTFTTD
DTTTFTTPTTFTTPD
DDDDDDDDDDDDDDD
DDTPTFTPFTPFTPD
DDDDDTTTTTDDDDD