DDRDDDDDDDDDDDD
DDDPTTTDDFTTTDD
DDDDDDDDDDDDDDD
DDDDDDDTTTPTTDD
DTTTTFTDDDDDDDD
DDDDDDDDDDDDDDD
DDDDDDDDDTTPTTD
DDDDDDDHRDDDDDD
DDDDRDDDDDDDDDD
DDTTDFTTDDDDDDR
DDDDDDDDDDDDDDD
DTTTFTTDDDDDDDD
DDDDDDDDDDDDDDD
DDDDDDDRDDDDDDD
DDDDDDDDDDDDDDD