DDRDDDDDDDDDDDD
DDDDDDDDDRDDDDD
DDDDDDDDDDDDDDD
DDDDDDDTTTPTTDD
DTTTTFTDDDDDDDD
DDDDDDDDDDDDDDD
DDDDDTDDDDDTDDD
DDDRDTDHRDDTDDD
DDDDTPTTDDDTDDD
DDDTTFTDDDDTDDD
DDDDDDDDDDPTDDD
DTTTFTTDDDDRDDD
DDDDDDDDDDDDDDD
DDDDDDDRDDTFTDD
DDDDDDDDDDDDDDD