DDDDDDDDDDDDDDD
DTTPTTDDDDDDDDD
DDDDDDDDDDDDDDD
DDDDDDDDDDDDDDD
DDDRDDDDDDDDDDD
DDDDDDDTDDDDDDD
DDDDDDDTDDDDDDD
DDDDDDDDDDDDDDD
DDDDDDDHDDDDDDD
DDDDDDDDDDDDDDD
DDDDDDDTDRDDDDD
DDDDDDDTDDDDDDD
DDDDDDDDTTFTDDD
DDDDDDDDDDDDDDD
DDDDDDDDDDDDDDD